NO ./textures/north.xpm
SO ./textures/south.xpm
WE ./textures/west.xpm
EA ./textures/east.xpm

F 220,100,0
C 225,30,0
     1111111111
   11110000001111
 111100000000001111
11100001111111000111
100000111   111000011
1110000111 110001111
  11110000110001011
    11111111100101
  11111  1000N010011111
11100011111111000000001
110000111   111000011
111000011  111000111
 111100001100001111
   11110000001111
     1111111111