NO ./textures/3.xpm
F 230,230,230
C 230,230,230
WE ./textures/south_100.xpm
EA ./textures/south.xpm
SO ./textures/west.xpm 


    11111111111111
  111000000000000111
111100000000000000111
110000111111111000011       
1000111       1110001       
100011         110001       
100111          111001       
1001111111111111111001       
100011100000000000001      
110000111111111000011       
 1100000000000000111
  111000000000000000111
    11111111111111
