NO ./textures/north.xpm
SO ./textures/south.xpm
WE ./textures/west.xpm
EA ./textures/east.xpm

F 220,100,0
C 225,30,0

        1111111111111111111111111
        1000000000110000000000001
        1011000001110000000000001
        1001000000000000000000001
111111111011000001110000000000001
10000000001100000111011111111111 1
11110111111111011100000010001 1   1
11110111111111011101010010001 1 1  1
11000000110101011100000010001  1    1
10000000000000001100000010001 1
10000000000000001101010010001
11000001110101011111011110S0111 1
11110111 1110101 101111010001  1 1
11111111 1111111 111111111111
1       1                    1
 1                            1
  1                            1
                                111
                                101
                                111




