NO ./textures/north.xpm
SO ./textures/south.xpm
WE ./textures/west.xpm
EA ./textures/east.xpm

F 220,100,0
C 225,30,0

11111111111111111111111111
11111111111111111111111111
11111111111111111111111111
111111111111111111111
111111111111111
1111111111
111111
111111  111111111111111111
111111  111100000000011111111111111
111111  11110000000S0011111
111111  111100000000001111
111111  111111111111111111
111111  111111111111111111
111111  111111111111111111
111111
111111
111111
111111
111111
111111
111111

