C 225,30,0
NO ./textures/north.xpm



SO ./textures/south.xpm
F 220,100,0


WE ./textures/west.xpm
EA ./textures/east.xpm



             1
            101
           10N01
          1111111

