NO ./textures/north.xpm
SO ./textures/south.xpm
WE ./textures/west.xpm
EA ./textures/east.xpm

F 220,100,0
C 225,30,0

                             1111111111111
     111111                  1000000000001
     100001      11111111111110000000000011111
     100001      10000000000010000000000010001
     1000001     10000000000000000000000000001
     1000001     10000000000010000000000010001
     11111011111 10001111111110000000000011111
     10000000001 10001       1000000000001
     1000000000111000111      111110111111
     1000000000100000001          10001
     1000000000000000001          10001
     1000000000100000001          10001
111111000000000111111111          10001
1000110000000001                  10001
100011111101111              111111000111
1000100010001                100000000001
1101100010001                100111000111
1000111110001                1001110001
1000100010001                1001110001
1000000010001                1111110001
1000100010001                     10001
1000111111011111                  11011                1111111111
1000110000000001            111111000001111111         1000000001
1000110000000001            100000000000000011         1000000001
1000110000000001            1000000000000000111111111111000000001
1000010000000001            1000000000000000010000000001000000001
1000000000000001            1000000000000000000000000000000000001
1000010000000001            1000000000000000010000000001000000001
1000110000000001            1000000000000000111100001111000000001
1000110000000001            100000000000000011111001   1000000001
1000110000000001            11111100000111111   1001   1000000001
1000111111011111                 111011         1001   1110110111
1000111110001                     10001         1001     111111
1000111110001                     10001         1001
1000100010001                     10001         1001 111111111
1000000010001                     10001         100111010101011
1000100010001                     10001         100010000000001
1000111110001                     10001         100000000000001
1000111110001111111111111         10001         100010000000001
100000000000000001000000111       10001         111111010101011
100000000000000000000000001       10001              111111111
100000000000000001000000111       10001
1111111111111111110111111         10001
          11001000001        111111101111111
         10000100101         100001000100001
          1100000011         100000000000001
            101111           100001000100001
            1001             100001000100001
            1S01             111111000111111
            1111             100001000100001
                             100000000000001
                             100001000100001
                             111111000111111
                             100000000000001
                             100000000000001
                             111111111111111