NO ./textures/north.xpm
SO ./textures/south.xpm
WE ./textures/west.xpm
EA ./textures/east.xpm

F 139,105,105
C 255,193,193







        1111111111111111111111111
        1N00000000000000000000001
        1000000000000000000000001
        1000000000000000000000001
        1000000000000000000000001
        1000000000000000000000001
        1000000000000000000000001
        1000000000000000000000001
        1000000000000000000000001
        1000000000000000000000001
        1000000000000000000000001
        1000000000000000000000001
        1000000000000000000000001
111111111011111111110111111111111
100000000000000001110111111111111
11110111110011011100000010001
11110111110011011101010010001
11000000110001011100000010001
10000000000000001100000010001
10000000000000001101010010001
1100000111010101111101111000111
11110111 1110101 101111010001
11111111 1111111 111111111111



