NO ./textures/north.xpm
SO ./textures/south.xpm
WE ./textures/west.xpm
EA ./textures/east.xpm

F 220,100,0
C 225,30,0



                   1
                  101
                 10001
                1000001
              11000000011
        1111110000000000011111
       100000000011000000000001
       1011000001110000000000001
       1001000000000000000000001111
   111111111011000001110000000000001
    100000000011000001110111111111111
    11110111111111011100000010001
    1111011111111W011101010010001
    11000000110101011100000010001
    10000000000000001100000010001
    10000000000000001101010010001
    1100000111010101111101111000111
    11110111 1110101 101111010001
    11111111 1111111 111111111111
                                  





