NO ./textures/north.xpm
SO ./textures/south.xpm
WE ./textures/west.xpm
EA ./textures/east.xpm

F 220,100,0
C 225,30,0

111111111111
110000000011
100000000001
100000S00001
110000000011
111111111111