NO ./textures/north.xpm
SO ./textures/south.xpm
WE ./textures/west.xpm
EA ./textures/east.xpm

F 220,100,0
C 225,30,0

11
111111
100111111
10S000001
10000001
10000011
100001001
10001 111
11111111