NO ./textures/north.xpm
SO ./textures/south.xpm
WE ./textures/west.xpm
EA ./textures/east.xpm

F 220,100,0
C 225,30,0

11
111111
1E01 1
100011
10000011
1000001111
1000001101
1000000011
11111111