NO ./textures/3.xpm
F 230,230,230
C 230,230,230
WE ./textures/south.xpm
EA ./textures/south.xpm
SO ./textures/west.xpm 


    11111111111111
  11100000E000000111
111100000000000000111
110000111111111000011
100011100000001110001
100011000000000110001
100111000000000111001
100111000000000111001
100011100000000000001
110000111111111000011
 1100000000000000111
  111000000000000111
    11111111111111
