NO ./textures/north.xpm
SO ./textures/south.xpm
WE ./textures/west.xpm
EA ./textures/east.xpm

F 220,100,0
C 225,30,0

         1111111111
        111111111111
       10000000000001
      1000000000000001
     100000000000000001
    100000000000000000011
   10000000000000000000001
  1000000000000000000000001
 100000000000000000000000001
10000000000000000000000000001
100000000000N0000000000000001
10000000000000000000000000001
 100000000000000000000000001
  1000000000000000000000001
   10000000000000000000001
    100000000000000000011
     100000000000000001
      1000000000000001
       10000000000001
        1111110001111
        111111001111
       10000000000001
      1000000000000001
     100000000000000001
    100000000000000000011
   10000000000000000000001
  1000000000000000000000001
 100000000000000000000000001
10000000000000000000000000001
10000000000000000000000000001
10000000000000000000000000001
 100000000000000000000000001
  1000000000000000000000001
   10000000000000000000001
    100000000000000000001
     1000000000000000011
      1000000000000001
       10000000000001
        1111111111111